____________________________
|000000000000000000000000000|
|000000000000000000000000000|
|$$10011100111111100111001$$|
|$$10011100100000100111001$$|
|001000000010000010000000100|
|001000000010010010000000100|
|001110010010010010010011100|
|000000010000010000010000000|
|000000010000010000010000000|
|110011111110010011111110011|
|110000010000000000010000011|
|110000010000000000010000011|
-000010010011111110010010000-
-00001000001#####10000010000-
|11111000001#####10000011111|
-000010010011111110010010000-
-000010010000000000010010000-
|110000010000000000010000011|
|110000011110010011110000011|
|110010000000010000000010011|
|110010000000010000000010011|
|110011110010010010011110011|
|000000000010000010000000000|
|000000000010000010000000000|
|001110010011111110010011100|
|001000010000000000010000100|
|$$10000100000000000100001$$|
|$$10011111100100111111001$$|
|000000000000010000000000000|
|000000000000010000000000000|
----------------------------
