1111111111111111111111111111
1000000000110000110000000001
1011111110110110110111111101
1311111110110110110111111131
1011000000000110000000001101
1011011011110110111101101101
1000011011110110111101100001
1111011011110110111101101111
1111011000000000000001101111
2000011110111111110111100002
1011011110111111110111101101
1011000000000000000000001101
1011110110111111110110111101
1011110110111111110110111101
1000000110111111110110000001
1011011110111111110111101101
1011011110111111110111101101
1011000000000000000000001101
1011110111110110111110111101
1011110111110110111110111101
1000000110000110000110000001
1110110110111111110110110111
1110110110111111110110110111
1300110000000000000000110031
1011110111110110111110111101
1011110111110110111110111101
1000000110000110000110000001
1011110110111111110110111101
1011110110111111110110111101
1000000110000000000110000001
1111111111111111111111111111