_____________________________
-000000010000000000010000000-
-000000010000000000010000000-
|111110010011111110010011111|
|$$00000000000100000000000$$|
|$$00000000000100000000000$$|
|001111110010010010011111100|
|001000000010010010000000100|
|001000000010000010000000100|
|001001110010000010011100100|
|000000010011111110010000000|
|000000010000000000010000000|
|111110010000000000010011111|
|000000010011111110010000000|
|00000001001#####10010000000|
|00111000001#####10000011100|
|000010000011111110000010000|
|000010010000000000010010000|
|110010010000000000010010011|
|110010011100111001110010011|
|110000000000111000000000011|
|110000000000111000000000011|
|110011111100111001111110011|
-000000010000000000010000000-
-000000010000000000010000000-
|110010010011111110010010011|
|$$00100000000100000000100$$|
|$$00100000000100000000100$$|
|001110011110010011110011100|
|000000000000000000000000000|
|000000000000000000000000000|
-----------------------------