1111111111111111111111111111
3000000110000000000110000003
1111110110111111110110111111
1111110110111111110110111111
1200000000000110000000000021
1011111110110110110111111101
1011111110110110110111111101
1011000000110110110000001101
1011011110110000110111101101
1011011110111111110111101101
1000000110111111110110000001
1111110110000000000110111111
1111110110111111110110111111
1000000110111111110110000001
1011110110111111110110111101
1011110000111111110000111101
1000110110111111110110110001
1110110110000000000110110111
1110110111101111011110110111
1110110111101111011110110111
1110000000001111000000000111
1110111111101111011111110111
1110111111101111011111110111
3000000110000000000110000003
1110110110111111110110110111
1110110110111111110110110111
1200110000000110000000110021
1011110111110110111110111101
1011110111110110111110111101
1000000000000000000000000001
1111111111111111111111111111