_____________________________
|000000010000000000010000000|
|$$00000100000000000100000$$|
|$$00000100111111100100111$$|
|000000000000000000000000000|
|000000000000000000000000000|
|110010011110010011110010011|
|110010011110010011110010011|
-000010000000010000000010000-
-000010000000010000000010000-
|110011110011111110011110011|
|110000000000000000000000011|
|110000000000000000000000011|
|110011110011111110011110011|
|11001000001#####10000010011|
|11001000001#####10000010011|
|110010010011111110010010011|
-000000010000000000010000000-
-000000010000000000010000000-
|110011111110010011111110011|
|110000000000010000000000011|
|110000000000010000000000011|
|110011110011111110011110011|
|000000000000000000000000000|
|000000000000000000000000000|
|001110011110010011110011100|
|001110010000010000010011100|
|$$11100100000100000100111$$|
|$$11100100111111100100111$$|
|000000000000000000000000000|
|000000000000000000000000000|
-----------------------------
